ABOUT	AH B AW T
ADAPTER	AH D AE P T ER
AIRBORNE	EH R B AO R N
BOOT	B UW T
BOTTLE	B AA T AH L
CAN	K AE N
CAN(2)	K AH N
CAP	K AE P
CORRECT	K ER EH K T
COULD	K UH D
DISK	D IH S K
DO	D UW
GIVE	G IH V
GOOD	G UH D
GOOD(2)	G IH D
HALLS	HH AO L Z
HOW	HH AW
INFORMATION	IH N F ER M EY SH AH N
INFORMATION(2)	IH N F AO R M EY SH AH N
JOB	JH AA B
JOB(2)	JH OW B
LIKE	L AY K
ME	M IY
NO	N OW
NOT	N AA T
OF	AH V
OPTIONS	AA P SH AH N Z
OPTIONS(2)	AO P SH AH N Z
PEOPLE	P IY P AH L
PLEASE	P L IY Z
POWDER	P AW D ER
REVIEWS	R IY V Y UW Z
REVIEWS(2)	R AH V Y UW Z
SEE	S IY
SHOW	SH OW
SOME	S AH M
THANK	TH AE NG K
THINK	TH IH NG K
THIS	DH IH S
TOY	T OY
TUMBLER	T AH M B L ER
TUPPERWARE	T AH P ER W EH R
UMBRELLA	AH M B R EH L AH
WRONG	R AO NG
YOU	Y UW
